//MAP CONVERTED BY dmm2tgm.py THIS HEADER COMMENT PREVENTS RECONVERSION, DO NOT REMOVE
"a" = (
/obj/effect/turf_decal/trimline/brown/filled/line{
	dir = 8
	},
/turf/open/floor/iron,
/area/space)
"b" = (
/turf/open/floor/iron/dark/textured_large,
/area/space)
"d" = (
/obj/machinery/door/airlock/maintenance_hatch,
/turf/open/space/basic,
/area/space)
"e" = (
/obj/structure/sign/warning/pods/directional/east,
/obj/effect/turf_decal/trimline/green/warning{
	dir = 5
	},
/turf/closed/wall/r_wall,
/area/space)
"f" = (
/obj/structure/table/wood,
/obj/item/camera{
	pixel_x = 6;
	pixel_y = 3
	},
/obj/item/camera_film{
	pixel_x = -5;
	pixel_y = 3
	},
/obj/item/camera_film{
	pixel_x = -4;
	pixel_y = 7
	},
/turf/open/floor/wood,
/area/space)
"g" = (
/obj/structure/table/wood,
/turf/open/floor/carpet/executive,
/area/space)
"h" = (
/obj/structure/chair/comfy/black{
	dir = 4
	},
/obj/effect/landmark/start/nanotrasen_consultant,
/turf/open/floor/carpet/executive,
/area/space)
"i" = (
/obj/machinery/light/warm/directional/south,
/turf/open/floor/carpet/executive,
/area/space)
"j" = (
/obj/machinery/photocopier,
/turf/open/floor/carpet/executive,
/area/space)
"k" = (
/obj/effect/turf_decal/trimline/brown/filled/line,
/obj/machinery/atmospherics/pipe/smart/manifold4w/supply/hidden/layer4,
/obj/structure/cable,
/obj/machinery/atmospherics/pipe/smart/manifold4w/scrubbers/hidden/layer2,
/turf/open/floor/iron,
/area/space)
"l" = (
/obj/machinery/light/directional/east,
/turf/open/floor/carpet/royalblue,
/area/space)
"m" = (
/obj/effect/turf_decal/siding/wood{
	dir = 1
	},
/obj/machinery/atmospherics/pipe/smart/manifold4w/scrubbers/hidden/layer2,
/turf/closed/wall/r_wall,
/area/space)
"n" = (
/obj/structure/displaycase/trophy{
	dir = 8
	},
/turf/open/floor/wood,
/area/space)
"o" = (
/turf/closed/wall,
/area/space)
"p" = (
/turf/closed/wall/r_wall,
/area/space)
"q" = (
/turf/open/floor/carpet/royalblue,
/area/space)
"r" = (
/obj/structure/closet/secure_closet/nanotrasen_consultant,
/turf/open/floor/carpet/executive,
/area/space)
"s" = (
/obj/machinery/door/airlock/corporate{
	name = "NT Consultant's Office";
	id_tag = "nt_rep_maint"
	},
/obj/effect/mapping_helpers/airlock/access/all/cent_com/rep_door,
/obj/machinery/atmospherics/pipe/smart/manifold4w/scrubbers/hidden/layer2,
/obj/structure/cable,
/obj/machinery/atmospherics/pipe/smart/manifold4w/supply/hidden/layer4,
/obj/machinery/door/firedoor,
/turf/open/floor/plating,
/area/space)
"t" = (
/obj/machinery/door/airlock/wood{
	name = "Bedroom"
	},
/turf/open/floor/carpet/royalblue,
/area/space)
"u" = (
/obj/item/kirbyplants/photosynthetic,
/obj/machinery/power/apc/auto_name/directional/north,
/obj/structure/cable,
/obj/machinery/light/warm/directional/north,
/turf/open/floor/iron/dark/textured_large,
/area/space)
"v" = (
/turf/open/space/basic,
/area/space)
"y" = (
/obj/effect/turf_decal/trimline/brown/filled/line{
	dir = 8
	},
/obj/structure/sign/directions/evac/directional/west,
/turf/open/floor/iron,
/area/space)
"z" = (
/obj/effect/turf_decal/trimline/brown/filled/line{
	dir = 10
	},
/obj/item/kirbyplants/random,
/obj/structure/extinguisher_cabinet/directional/west,
/turf/open/floor/iron,
/area/space)
"A" = (
/obj/machinery/atmospherics/pipe/smart/manifold4w/supply/hidden/layer4,
/obj/structure/cable,
/obj/machinery/atmospherics/pipe/smart/manifold4w/scrubbers/hidden/layer2,
/turf/open/floor/iron,
/area/space)
"B" = (
/obj/effect/turf_decal/siding/wood/corner{
	dir = 4
	},
/obj/structure/cable,
/turf/open/floor/iron/dark/textured_large,
/area/space)
"D" = (
/obj/machinery/door/airlock/corporate{
	name = "NT Consultant's Office";
	id_tag = "nt_rep_maint"
	},
/obj/structure/disposalpipe/segment,
/obj/machinery/door/firedoor,
/obj/effect/mapping_helpers/airlock/access/all/cent_com/rep_door,
/turf/open/floor/iron,
/area/space)
"E" = (
/obj/structure/table/wood,
/obj/item/stamp/centcom{
	pixel_y = 13;
	pixel_x = -7
	},
/obj/item/folder/blue,
/turf/open/floor/carpet/executive,
/area/space)
"F" = (
/turf/open/floor/carpet/executive,
/area/space)
"G" = (
/obj/structure/fireplace,
/turf/open/floor/iron/dark/textured_large,
/area/space)
"H" = (
/obj/machinery/atmospherics/pipe/smart/manifold4w/supply/hidden/layer4,
/obj/machinery/atmospherics/pipe/smart/manifold4w/scrubbers/hidden/layer2,
/obj/structure/cable,
/obj/structure/disposalpipe/segment{
	dir = 4
	},
/obj/machinery/door/airlock/maintenance_hatch,
/turf/open/floor/catwalk_floor,
/area/space)
"I" = (
/obj/structure/dresser,
/obj/structure/sign/poster/random/directional/west,
/turf/open/floor/carpet/royalblue,
/area/space)
"J" = (
/obj/effect/spawner/structure/window/reinforced,
/obj/machinery/door/poddoor/preopen{
	id = "nt_rep_priv";
	name = "Privacy Shutter"
	},
/turf/open/floor/plating,
/area/space)
"K" = (
/obj/structure/chair{
	dir = 8
	},
/turf/open/floor/carpet/executive,
/area/space)
"L" = (
/obj/structure/bed{
	dir = 1
	},
/obj/item/bedsheet/blue{
	dir = 4
	},
/obj/item/toy/plush/snakeplushie{
	pixel_x = -6;
	pixel_y = 7
	},
/obj/effect/landmark/start/assistant,
/turf/open/floor/carpet/royalblue,
/area/space)
"N" = (
/obj/structure/filingcabinet/employment,
/turf/open/floor/carpet/executive,
/area/space)
"O" = (
/obj/structure/table/wood,
/obj/item/paper_bin/carbon{
	pixel_y = 4;
	pixel_x = -4
	},
/obj/item/pen/fountain{
	pixel_x = -4;
	pixel_y = 6
	},
/obj/item/stamp{
	pixel_x = 8;
	pixel_y = 8
	},
/obj/item/stamp/denied{
	pixel_x = 8
	},
/obj/machinery/button/door/directional/west{
	id = "nt_rep_priv";
	name = "Privacy Shutters Control"
	},
/obj/machinery/button/door/directional/west{
	id = "nt_rep_maint";
	name = "Door Bolts Control";
	specialfunctions = 4;
	normaldoorcontrol = 1;
	pixel_x = -37
	},
/turf/open/floor/carpet/executive,
/area/space)
"P" = (
/obj/machinery/camera/autoname/directional/east,
/turf/open/floor/wood,
/area/space)
"Q" = (
/obj/machinery/atmospherics/components/unary/vent_scrubber/on/layer2{
	dir = 4
	},
/turf/open/floor/iron,
/area/space)
"R" = (
/obj/structure/table/wood,
/obj/machinery/fax{
	fax_name = "Nanotrasen Consultant's Office";
	name = "Nanotrasen Consultant's Fax Machine"
	},
/turf/open/floor/carpet/executive,
/area/space)
"S" = (
/turf/template_noop,
/area/space)
"T" = (
/obj/machinery/door/poddoor/preopen{
	id = "nt_rep_priv";
	name = "Privacy Shutter"
	},
/turf/closed/wall/r_wall,
/turf/open/floor/plating,
/area/space)
"U" = (
/obj/machinery/airalarm/directional/north,
/obj/effect/turf_decal/tile/green/anticorner{
	dir = 1
	},
/turf/template_noop,
/area/space)
"V" = (
/turf/open/floor/wood,
/area/space)
"W" = (
/obj/machinery/firealarm/directional/west,
/turf/open/floor/wood,
/area/space)
"X" = (
/obj/structure/sign/flag/nanotrasen/directional/north,
/obj/machinery/atmospherics/components/unary/vent_scrubber/on/layer2,
/turf/closed/wall/r_wall,
/area/space)
"Y" = (
/obj/machinery/light_switch/directional/south,
/turf/open/floor/iron/dark/textured_large,
/area/space)
"Z" = (
/obj/effect/turf_decal/trimline/green/warning{
	dir = 1
	},
/turf/closed/wall/r_wall,
/area/space)

(1,1,1) = {"
o
L
I
o
p
p
p
H
Z
o
"}
(2,1,1) = {"
t
q
l
o
R
N
r
F
e
o
"}
(3,1,1) = {"
p
p
p
p
j
F
F
F
p
o
"}
(4,1,1) = {"
p
b
W
V
g
h
F
F
p
U
"}
(5,1,1) = {"
T
G
V
V
O
E
g
F
p
S
"}
(6,1,1) = {"
T
b
V
V
F
K
K
i
p
S
"}
(7,1,1) = {"
D
b
b
b
b
b
b
b
p
S
"}
(8,1,1) = {"
J
u
B
b
b
b
Y
b
s
S
"}
(9,1,1) = {"
p
X
m
p
P
n
f
V
p
S
"}
(10,1,1) = {"
p
v
v
p
p
p
p
d
p
o
"}
(11,1,1) = {"
p
v
v
p
S
S
S
a
y
z
"}
(12,1,1) = {"
p
p
p
p
S
S
S
Q
A
k
"}
